-9
10
-6
7
00000000000000000000
00000000000000000000
00000000000000000000
00000000000000000000
00000000000000000000
00111000000110000000
00111000000000000000
00000000000000010000
00000000000000100000
00000001000000000000
00110000000011100000
00000000000011100000
00011100000000000000
00000000000000000000
